AREA 0
  0   0   0   0   0   0   0   0   0   0   0   0   0   0   0   0   0   0   0   0   0   0   0   0   0
  0   0   0   0   0   0   0   0   0   0   0   0   0   0   0   0   0   0   0   0   0   0   0   0   0
  0   0   0   0   0   0   0   0   0   0   0   0   0   0   0   0   0   0   0   0   0   0   0   0   0
  0   0   0   0   0   0   0   0   0   0   0   0   0   0   0   0   0   0   0   0   0 100   0   0 100
  0   0   0   0   0 100   0   0 100 100 100 100   0 100 100   0   0   0   0 100 100  30  30   0  30
  0   0   0   0   0   0   0   0   0   0 100   0   0   0   0   0   0   0   0  32  32   0   0   0   0
  0   0   0   0   0   0 100 100 100 100 100 100   0   0   0   0   0   0   0   0  32 100 100 100   0
  0   0   0   0   0   0   0   0  51   0  51   0   0   0  32   0 100 100  29  32   0   0   0   0   0
  0   0   0   0 100 100 100   0 100 100 100 100 100  32  32   0   0   0  30  32  32 100   0 100   0
  0   0   0   0   0   0   0   0   0  96  96  29  29  29  29  29 100 100 100  32  32  51   0   0   0
  0   0   0   0   0   0   0   0  29  96   0  95   0  95  95   0   0  51   0   0   0   0   0   0   0
  0   0   0   0   0   0   0   0  37  96  96  95   0  95  95  95  95  95  95  95  95  95 105 101   0
  0   0   0   0   0   0   0  80  37  37  37  80   0  80  37   0   0   0   0   0  95   0   0   0   0
  0   0   0   0   0   0   0   0  37  37  80  80  80  80  37  37   0  80  80   0  37  37   0   0 101
  0   0   0   0   0   0   0  80  80  80  80  80  80  80  80  37  80  80  37  80  80  37  97   0   0
  0   0   0   0   0   0   0   0   0   0   0   0   0   0   0   0   0   0   0   0   0   0   0   0   0
  0 101 101 101 101 101   0 101 101 101 101   0   0   0   0   0 101 101   0   0   0   0   0   0   0
  0   0   0   0   0   0   0   0   0   0   0   0   0   0   0   0   0   0   0   0   0   0   0   0   0

AREA 1
  0   0   0   0   0   0   0   0   0   0  84  89  89  89  89  89   0   0   0   0  49   0   0   0   0
  0   0   0   0   0   0   0   0   0   0   0  84  84  84  84  89  84  49  88  49   0   0  49   0   0
  0   0  87  87  87  87  87   0   0   0   0  84  84  84  84  84  84   0   0  49   0   0   0  49  49
  0   0  86  86  86  86  86   0  86  87   0  84  84   0  84  89  89   0   0   0   0   0   0   0   0
  0   0   0   0   0  87  87   0   0  87   0  83  83  84  84  89   0   0   0  49   0  49  49   0   0
  0   0  87  87   0  87  86   0   0  86  85  85  83  84   0  84  84  89  84   0  49  94  49   0  49
  0   0   0   0 125  86  86  86   0  86  86   0   0  86  86  86  86  87   0  87  49   0   0   0   0
  0   0 125   0 125  86  86   0  86   0   0   0   0   0   0   0  86  86  86  87   0   0   0   0   0
  0   0   0   0   0   0   0   0 125  86  86   0   0   0   0   0  33   0   0   0   0   0   0   0   0
  0   0   0 125   0   0   0   0 125 125 125   0   0   0   0  33 108  33   0   0   0   0   0   0   0
  0   0   0   0   0   0   0   0   0   0   0   0   0   0   0  33 108  33  33   0   0   0   0   0   0
  0  33   0   0  33  33  33 109 109  33  33   0  33  33  33 108 108 108  33  33  33  33  33  33  33
  0   0   0  96  96  96   0   0   0  96 100   0 108  12  12  12 108 108 108 108 108   0   0   0   0
  0   0   0  95   0   0   0  96  96   0   0   0   0  12  12  12  12  12  12 108 108   0   0   0   0
  0   0   0   0   0   0   0   0   0   0   0   0   0  12 108   0 108 108 108 108   0   0   0   0   0
  0   0  95  95   0   0   0   0   0   0   0  12  12  12  12 108 108 108 108   0   0   0   0   0   0
  0   0   0   0   0   0   0   0   0   0   0   0   0   0   0 108 108 108   0   0   0   0   0   0   0
  0   0   0   0   0   0   0   0   0   0   0   0   0   0   0   0   0   0   0   0   0   0   0   0   0

AREA 2
  0   0   0   0   0   0   0   0   0   0   0   0   0   0 127   0   0   0   0   0   0   0   0   0   0
  0   0   0   0   0  82  82   0   0   0   0   0   0 127 127 127   0   0   0   0   0   0   0   0   0
  0   0   0   0   0   0  82  82   0   0   0   0   0   0   0   0   0   0   0   0   0   0   0   0   0
  0   0   0   0  82   0  82  82   0   0   0   0  82  82  82  82   0   0   0   0   0   0   0   0   0
  0   0  90  70  82  82   0   0   0   0  82   0  82  82  82  82  82   0   0   0   0   0   0   0   0
  0   0  90   0  70   0   0   0   0  82   0   0   0 121 121 121 122 120 121 120   0 120 128 128   0
  0   0  90   0  82   0   0   0   0   0   0   0   0 122   0 122 122 120   0 120 120 128 128 128   0
  0   0   0   0   0   0  82   0   0   0   0   0   0   0   0 122 122 120 120   0   0 120   0   0   0
  0  70  90   0   0   0   0   0   0   0   0   0   0   0   0  35   0  35 120   0   0   0   0   0   0
  0  90  90  70   0  70   0   0   0   0   0   0   0   0   0   0   0   0  35 120   0   0   0   0   0
  0   0  90  70  70   0   0   0   0   0   0   0   0   0   0   0   0   0   0  35   0 120   0   0   0
  0  70  70  96  96   0   0   0   0   0   0   0   0   0   0   0   0   0   0  35  35  35 120   0   0
  0  90   0  38  38   0   0   0   0   0   0   0   0   0   0   0  35   0   0   0  35  35   0   0   0
  0   0   0   0  38  38   0   0   0   0   0   0   0   0   0   0  35   0   0   0   0   0   0   0   0
  0   0  90  38  38   0   0   0   0   0   0   0   0   0   0   0  35   0   0  35  35  35   0   0   0
 90  90  90  96  38  38  38  38   0   0   0   0   0   0   0   0   0  35  35   0   0   0   0   0   0
  0  71  70  70  70  70   0  70  70  36  36   0  36   0  36  34  35  35  35   0   0   0   0   0   0
  0   0   0   0   0   0   0   0   0   0   0   0   0   0   0   0   0   0   0   0   0   0   0   0   0

AREA 3
  0   0   0   0   0   0   0   0   0   0   0   0   0   0   0   0   0   0   0   0   0   0   0   0   0
  0   0   0   0   0   0   0   0   0   0   0   0   0   0   0   0   0   0   0   0   0   0   0   0   0
  0   0   0   0   0   0   0   0   0   0   0   0   0   0   0   0   0   0   0   0   0   0   0   0   0
  0  76  76   0  76   0  76  77  77  77   0   0   0   0   0   0   0   0   0   0   0   0   0   0   0
  0  78  76  76  76  76   0   0   0   0   0   0   0   0   0   0  77   0   0   0   0   0   0   0   0
  0   0  78  76  76  76  78   0   0   0   0   0   0   0   0  77   0   0   0   0   0   0   0   0   0
  0   0  78  76  76  76  78   0   0   0  77  76  76  77   0   0   0   0   0   0   0   0   0   0   0
  0  75  78  78  78  78  78   0   0   0  77   0   0   0   0   0   0   0   0   0   0   0   0   0   0
  0  75  75  75   0   0   0   0   0   0   0   0   0  77   0  77   0   0  77   0   0   0   0   0   0
  0  75  75   0   0   0  75  75   0  75  75   0   0  75   0  75   0   0   0   0   0   0   0   0   0
 75   0   0   0   0   0   0   0  75  75  75  75  75   0   0   0   0  75   0   0   0   0   0   0   0
  0   0   0   0   0   0   0  75   0   0  75  79   0   0   0   0   0   0   0  75  75  75  75  75   0
  0   0   0   0   0   0   0  79   0   0   0   0   0   0   0   0   0   0   0   0   0   0   0   0   0
  0   0   0   0   0   0   0   0   0   0   0   0   0  79   0   0   0   0  75   0   0   0  75   0   0
  0   0   0   0   0   0   0   0   0   0  79  79   0   0   0   0  75   0  79  79   0   0  79   0   0
  0   0   0  79   0   0   0   0   0   0   0   0   0   0   0   0  79   0   0   0   0   0   0  79   0
  0   0   0   0   0   0   0   0   0   0  79  99  79   0   0   0   0   0  79   0   0   0   0   0   0
  0   0   0   0   0   0   0   0   0   0   0   0   0   0   0   0   0   0   0   0   0   0   0   0   0

AREA 4
  0   0   0   0   0   0   0   0   0   0   0   0   0   0   0   0   0   0   0   0   0   0   0   0   0
  0   0   0   0   0   0   0   0   0   0   0   0   0   0   0   0   0   0   0   0   0   0   0   0   0
  0   0   0   0   0   0   0   0   0   0   0   0   0   0   0   0   0   0   0   0   0   0   0   0   0
  0   0   0   0   0   0   0   0   0   0   0   0   0   0   0   0   0   0   0   0   6   0   0   6   0
  0   0   0   0   0   0   0   0   0   0   0   6   0   0   6   6   6   0   6   6   6   0   0   0   0
  0   0   0   0   0   0   0   0   0   0   0   0   0   0   0   0   0   6   6   0   0   0   0   6   0
  0   0   0   0   0   0   0   0   0   0   0   0   0   0   0   0   0   0   6   0   0   0   0   0   0
  0   0   0   0   0   0   0   0   0   0  67  68  67  67  56  56   6   6   6   6   6   6   0   0   0
  0   0   0   0  67  68  67   0   0   0  67  68   0   0   0   6   6   0   0   0   0   0   0   0   0
  0   0   0   0  68  68  67   0   0  67  68   0   0   0   0   0   0   0   0   0   0   0   0   0   0
  0  67  67  67  67  67  67   0  67  67  68   0   0   0   0   0   0   0   0   0   0   0   0   6   0
  0   0  68  68  68  68   0   0  68  68   0  68   0   0   0   0   0   0   0   0   0   0   0   0   0
  0  67  67  67  67  67  67  67  68   0  68  68  67   0   0   0   6   0  62  61  61  62  58  58  60
  0   0   0   0  68   0   0  68   0   0   0   0  68  68  56  56  56  57  57   7   7  59  58  58  60
  0   0   0   0   0   0   0   0   0   0   0   0   0  62  62  62  62  62  62   0  62  62  58  58  60
  0   0   0   0   0   0   0   0   0   0   0   0  62  62  62  62   0  62  62  57  58  62  60  63  60
  0   0   0   0   0   0   0   0   0   0   0  62  58   0  58  62  80  64  63   0  63  61  60  63  60
  0   0   0   0   0   0   0   0   0   0   0   0   0   0   0   0   0   0   0   0   0   0   0   0   0

AREA 5
  0   0   0   0   0   0   0   0   0   0   0   0   0   0   0   0   0   0   0   0   0   0   0   0   0
  0   0   0   0   0   0   0   0   0   0   0   0   0   0   0   0   0   0   0   0   0   0   0   0   0
  0   0   0   0   0   0   0   0   0   0   0   0   0   0   0   0   0   0   0   0   0   0   0   0   0
  0   0   0   0   0   0   0   0   0   0   0   0   0   0   0   0   0   0   0   0   0   0   0   0   0
  0   0   0   0   0   0   0   0   0   0   0   0   0   0   0   0   0   0   0   0   0   0   0   0   0
  0   0   0   0   0   0   0   0   0   0   0   0   0   0   0   0   0   0   0   0   0   0   0   0   0
  0   0   0   0   0   0   0   0   0   0   0   0   0   0   0   0   0   0   0   0   0   0   0   0   0
  0   0   0   0   0   0   0   0   0   0   0   0   0   0   0   0   0   0   0   0   0   0   0   0   0
  0   0   0   0   0   0   0   0   0   0   0   0   0   0   0   0   0   0   0   0   0   0   0   0   0
  0   0   0   0   0   0   0   0   0   0   0   0   0   0   0   0   0   0   0   0   0   0   0   0   0
  0   0   0   0   0   0   0   0   0  74   0 118   0   0   0   0   0   0   0   0   0   0   0   0   0
  0   0   0   0   0   0   0   0   0   0   0   0   0   0   0   0   0   0   0   0   0   0   0   0   0
  0   0   0   0   0   0   0   0  11  11  11  11  11   0  11  11  11   0   0   0   0   0   0   0   0
  0   0   0   0   0   0   0   0   0   0   0   0   0   0   0   0   0   0   0   0   0   0   0   0   0
  0   0   0   0   0   0   0   0   0   0   0   0   0   0   0   0   0   0   0   0   0   0   0   0   0
  0   0   0   0   0   0   0   0   0   0   0   0   0   0   0   0   0   0   0   0   0   0   0   0   0
  0   0   0   0   0   0   0   0   0   0   0   0   0   0   0   0   0   0   0   0   0   0   0   0   0
  0   0   0   0   0   0   0   0   0   0   0   0   0   0   0   0   0   0   0   0   0   0   0   0   0

AREA 6
  0   0   0   0   0   0   0   0   0   0   0   0   0   0   0   0   0   0   0   0   0   0   0   0   0
  0   0   0   0   0   0   0   0   0   0   0   0   0   0   0   0   0   0   0   0   0   0   0   0   0
  0   0   0   0   0   0   0   0   0   0   0   0   0   0   0   0   0   0   0   0   0   0   0   0   0
  0   0   0   0   0   0   0   0 113 113 113 114 113   0   0 113   0   0   0   0   0   0   0   0   0
  0   0   0   0   0   0   0   0 116   0   0 116 113 113 113 113   0   0   0   0   0   0   0   0   0
  0   0   0   0   0   0   0   0 116 116   0   0   0   0   0   0   0   0   0   0   0   0   0   0   0
  0   0   0   0   0   0   0   0  95  95   0   0   0   0   0   0   0   0   0   0   0   0   0   0   0
  0   0   0   0   0   0   0   0 112   0   0   0   0   0   0   0   0   0   0   0   0   0   0   0   0
  0   0   0   0   0   0   0   0 115 112   0   0   0   0 112 112 113   0   0   0   0   0   0   0   0
  0   0   0   0   0   0   0   0 115  96   0  96 113   0   0   0   0   0   0   0   0   0   0   0   0
  0   0   0   0   0   0   0   0   0 114   0   0   0   0   0   0   0   0   0   0   0   0   0   0   0
  0   0   0   0   0   0   0   0   0   0   0   0   0   0   0   0   0   0   0   0   0   0   0   0   0
  0   0   0   0   0   0   0   0   0   0   0   0   0   0   0   0   0   0   0   0   0   0   0   0   0
  0   0   0   0   0   0   0   0   0 114   0   0   0   0   0   0   0   0   0   0   0   0   0   0   0
  0   0   0   0   0   0   0   0   0  96   0   0   0   0   0   0   0   0   0   0   0   0   0   0   0
  0   0   0   0   0   0   0   0   0 115   0   0   0   0   0   0   0   0   0   0   0   0   0   0   0
  0   0   0   0   0   0   0   0   0   0   0   0   0   0   0   0   0   0   0   0   0   0   0   0   0
  0   0   0   0   0   0   0   0   0   0   0   0   0   0   0   0   0   0   0   0   0   0   0   0   0

AREA 7
  0   0   0   0   0   0   0   0   0   0   0   0   0   0   0   0   0   0   0   0   0   0   0   0   0
  0   0   0   0   0   0   0   0   0   0   0   0   0   0   0   0   0   0   0   0   0   0   0   0   0
  0   0   0   0  13   0   0   0   0   0   0   0   0   0   0   0   0   0   0   0   0   0   0  13   0
  0   0   0  13   0   0   0   0   0   0   0   0   0 107   0   0 107  14  14  13   0   0   0   0   0
  0   0   0 106   0   0 106 107   0 107 107 107 107 107 123 123   0   0   0   0   0   0   0   0 106
  0   0   0   0  23   0 106   0   0   0   0   0   0 123 123   0   0   0   0   0   0   0   0   0 106
  0   0   0   0   0  23  17  17 104  11  11 123   0   0   0   0   0   0   0   0   0   0   0   0 106
  0   0   0   0   0   0   6   6  79   0   0   0   0 123 123   0   0   0   0   0   0   0   0   0 106
  0   0   0   0   0   6  65   0   0   0   0   0   0   0   0   0   0   0  14 107 107  14  14  13 106
  0   0  37  80  80  65   0  65   0   0  79  51  74  23  23 123   0   0  14   0   0  14   0   0   0
  0   0   0   0   0 130 130   0   0   0   0   0   0 130 130 123   0   0 131   0   0 133 133 133   0
  0   0  37  95   0   0  95  96 132   0   0   0 132 132 130 104 131   0   0   0   0 131 131   0   0
  0  12 116  14 106  14 107  96   0   0   0 132   0   0 132 104 133 133   0   0   0   0   0 133   0
  0  12 108 108 108  77   0  77  76 126 126 126   0 126 104 104  68  38   0   0   0   0  38  75 106
  0   0   0   0   0   0  49  76  76  58  58  61  61  60 104 104  68   0  71  70  70  75  75   0  17
  0   0   0   0   0  76   0   0   0  82   0   0  82  60  67  67  67   0  71   0   0  33 100 100 100
  0   0   0   0   0  86   0   0  86  35   0   0  35   0   0   0   0   0  71  33   0  33   0   0   0
  0   0   0   0   0   0   0   0   0   0   0   0   0   0   0   0   0   0   0   0   0   0   0   0   0

AREA 8
  0   0   0   0   0   0   0   0   0   0   0   0   0   0   0   0   0   0   0   0   0   0   0   0   0
  0   0   0   0   0   0   0   0   0   0   0   0   0   0   0   0   0   0   0   0   0   0   0   0   0
  0   0   0   0   0   0   0   0   0   0   0   0   0   0   0   0 110   0 104   0   0   0   0   0   0
  0   0   0   0   0   0   0   0   0   0   0   0   0   0   0   0   0   0   0   0   0   0   0   0   0
  0   0   0   0   0   0   0   0   0   0   0   0   0   2   2   2   0   0   0  27  25  25  24  98  26
  0   0   0   0   0   0   0   0   0   0   0   0   0   0   2   2   0   0  53  27  25  25   0   0   0
  0   0   0   0   0   0   0   0   0   0   0   0   0   0   0   0   0   0   0  27  25  25  24  24  26
  0   0  28  28  28  28  28  28  28   9  93  93   0  93  93   9   0   9   9 111  25  25  24  24  26
  0   0   0   0   0   0   0   0   0   0   0   0   0   0   0   0   0   0   0   0   0   0   0   0   0
  0   0   0   0   0   0   0   0   0   0   0   0   0   0   0   0   0   0   0   0   0   0   0   0   0
  0   0   0   0   0   0   0   0   0   0   0   0   0   0   0   0   0   0   0   0   0   0   0   0   0
  0   0   0   0   0   0   0   0   0   0   0   0   0   0   0   0   0   0   0   0   0   0   0   0   0
  0   0   0   0   0   0   0   0   0   0   0   0   0   0   0   0   0   0   0   0   0   0   0   0   0
  0   0   0   0   0   0   0   0   0   0   0   0   0   0   0   0   0   0   0   0   0   0   0   0   0
  0   0   0   0   0   0   0   0   0   0   0   0   0   0   0   0   0   0   0   0   0   0   0   0   0
  0   0   0   0   0   0   0   0   0   0   0   0   0   0   0   0   0   0   0   0   0   0   0   0   0
  0   0   0   0   0   0   0   0   0   0   0   0   0   0   0   0   0   0   0   0   0   0   0   0   0
  0   0   0   0   0   0   0   0   0   0   0   0   0   0   0   0   0   0   0   0   0   0   0   0   0

AREA 9
  0   0   0   0   0   0   0   0   0   0   0   0   0   0   0   0   0   0   0   0   0   0   0   0   0
  0   0   0   0   0   0   0   0   0   0   0   0   0   0   0   0   0   0   0   0   0   0   0   0   0
  0   0   0   0   0   0   0   0   0   0   0   0   0   0   0   0   0   0   0   0   0   0   0   0   0
  0   0   0   0   0   0   0   0   0   0   0   0   0   0   0   0   0   0   0   0   0   0   0   0   0
  0   0   0   0   0   0   0   0   0   0   0   0   0   0   0   0   0   0   0   0   0   0   0   0   0
  0   0   0   0   0   0   0   0   0  65   0   0   0   0   0   0   0   0   0  65   0   0   0   0   0
  0   0   0   0   0   0   0   0   0  65  65   0  65   0  65  65  65   0   0   0   0   0   0   0   0
  0   0   0   0   0   0   0   0   0   0   0   0   0   0   0   0   0   0   0   0   0   0   0   0   0
  0   0   0   0   0   0   0   0   0   0   0   0   0   0  65  65  65  65  65   0   0   0   0   0   0
  0   0   0   0   0   0   0   0   0   0   0  65  66  66  66   0   0   0   0   0   0   0   0   0   0
  0   0   0   0   0   0   0   0  65   0   0   0   0   0  66   0   0   0   0   0   0   0   0   0   0
  0   0   0   0   0   0   0   0  66   0  66   0   0   0   0   0   0   0   0   0   0   0   0   0   0
  0   0   0   0   0   0   0   0  66   0   0   0   0   0   0   0   0   0   0   0   0   0   0   0   0
  0   0   0   0   0   0   0   0  66   0   0   0   0   0   0   0   0   0   0   0   0   0   0   0   0
  0   0   0   0   0   0   0   0   0   0   0   0   0   0   0   0   0   0   0   0   0   0   0   0   0
  0   0   0   0  66   0   0   0   0   0   0   0   0   0   0   0   0   0   0   0   0   0   0   0   0
  0   0   0   0   0   0   0   0   0   0   0   0   0   0   0   0   0   0   0   0   0   0   0   0   0
  0   0   0   0   0   0   0   0   0   0   0   0   0   0   0   0   0   0   0   0   0   0   0   0   0
